0000000000
0111111110
0100000010
0101111010
0101301010
0101101010
0101101010
0100001010
0111111010
0000000012
