000131000
000101000
000101000
000101000
000101000
000101000
000101000
000101000
000121000
