300000010000011000000000000000
111011010100000000001111111110
111010010001011000001000000010
100011011101000000001010000011
001110000101011011101010111000
100010010001000010001110101000
000011111111011010000000100000
000000000001000010111111111111
000111000001111110000100010001
010001011100000010000000010001
011111001000001010100000000111
010001111000000010001000000001
010000001000000011111110001000
010010000000000000001000111010
011111101111110000001010001010
000100100010100000000000001010
000100001000000000000010101010
000101011001000000011111110010
000000001111010000000000100110
000101011000010100000001100010
000000000001011110000000101110
000010000001010000000001101000
111111110001000000000000101011
010010000001010000000101101000
000000000111110000001111101011
000000000100000000000100001000
000010100100000000000101111011
111011111111000010000100000000
010010000000000000101111111010
000111000000100011100000000012
