30000000000000000101
01111110111111110000
01000010000000111110
01011011111110010011
01001010000010111011
01101011111110010001
01000000001100011011
01011110111001010001
00000010100011011011
11111010111111010001
00000010000000011010
01111111111011110111
00000010101001010000
00000000000100000110
01111101111111110110
00100000000000000110
01111010111111010110
01111000000001010000
01111011111111010111
00000000000000000002
