000000000000000000000000000000
000000000000000000000000000000
000000000000000000000000000000
000000000000000000000000000000
000000000000000000000000000000
000000000000000000000000000000
000000000000000000000000000000
000000000000000000000000000000
000000000000000000000000000000
000000000000000000000000000000
000000000000000000000000000000
000000000000000000000000000000
000000000000000000000000000000
000000000000000000000000000000
000000000000000000000000000000
000000000000000000000000000000
000000000000000000000000000000
000000000000000000000000000000
000000000000000000000000000000
000000000000000000000000111111
000000000000000000000000100000
000000000000000000000000101111
000000000000000000000000101000
000000000000000000001111101010
000000000000000011111000001010
000000000000001110000011111010
000000000000001000111110001010
000000000000001011100010101010
000000000000001001001010101010
000000000000000100011000101112
